H1;H2
BBBB1;BBBB1'
BBBB2;BBBB2'
BBBB3;BBBB3'
BBBB4;BBBB4'
BBBB5;BBBB5'
BBBB6;BBBB6'
