H1;H2
CCCC1;CCCC100-T01
CCCC2;CCCC100-T02
CCCC3;CCCC100-T03
CCCC4;CCCC100-T03
CCCC5;CCCC100-T04
CCCC6;CCCC100-T05
CCCC7;CCCC100-T06
CCCC8;CCCC100-T07
CCCC9;CCCC100-T08
CCCC10;CCCC100-T09
CCCC11;CCCC100-T10
CCCC12;CCCC100-T11
